25
15

 ╭──╮  ╭──╮
 ╰──┼──┼──┼────────────╮
 ╭──┼──┼──┼────────────╯
 ╰──┼──┼──┼────────────╮
 ╭──┼──┼──┼────────────╯
 ╰──┼──┼──┼────────────╮
 ╭──┼──┼──┼────────────╯
 ╰──┼──┼──┼────────────╮
    │  │  │            │
    │  │  │            │
    │  │  │            │
    ╰──╯  ╰────────────╯


1 2 7 L
2 7 4 R
0 0 5 R